XXXXXXXXXX
X..X.....X
X....XX.SX
XX.X.SX..X
X..XXXX.XX
X..X..XS.X
X..X.XX.XX
XXS11..P.X
X...X..X.X
XXXXXXXXXX