XXXXXXXXXX
X..X.....X
X....XX..X
XX.X..X..X
X..XXXX.XX
X..X..XS.X
X..X.XX.XX
XXS11..P.X
X...X..X.X
XXXXXXXXXX