XXXXXXXXXX
X.1X1111.X
X....XX..X
XX.XSSX..X
X..XXXX.XX
X..X1.X..X
X..X.XX.XX
XX.1111P.X
X...X..X.X
XXXXXXXXXX