XXXXXXXXXX
X..X.....X
X....XX.SX
XX.X..X..X
X..XXXX.XX
X..X..XS.X
X..X.XX.XX
XX.11..P.X
X...X..X.X
XXXXXXXXXX