XXXXXXXXXX
XS.X.....X
X....XX..X
XX.X.SX..X
X..XXXX.XX
X..X..X..X
X..X.XX.XX
XX.11..P.X
X...X..X.X
XXXXXXXXXX